1111111111
1C00000001
101000C101
1010001E01
1010000111
101C0000C1
1C00000001
101000C101
1010001001
1010000111
1P1C0000C1
1111111111