0111111110
1PCCCCCCC1
10100001X1
1010001E01
1010000111
1010000001
1010000001
1010000001
1010000001
0111111110