0111111110
1PCCCCCCC1
1000000001
1000000E01
1000000001
1000000001
1000000001
1000000001
1000000001
0111111110